...###
..##.#.####
.##...##..#
##........#
#..#...#..#
###..#....#
..#..#....#
.##..#.#.##
.#..#...##
.#..@..##
.#######