...###
..##.#.####
.##...##..#
##........#
#..#...#..#
###..#....#
..#..@....#
.##..#.#.##
.#..#...##
.#.....##
.#######